WWWWWWWWWWWWWWWWWWWWW
WGWGWGWGWGWGWGWGWEWW
WGWGWCWGWGWGWGWGWGWW
WGGGWGWGWGWGWGWGWGWW
WWWGWGWGWGWGWGWGWGWW
WWWGWGWGWGWGWGWGWGWW
WWWWWGWGWGWGWGWGWGWW
WGGGWGWGWGWGWGWGWGWW
WWWGWGWGWGWGWGWGWGWW
WGGGWGGGGGGGGGGGGGGW
WGWWWGWWWWWWWWWWWWWW
WGGGWGGGGGGGGGGGGGPW
WWWWWWWWWWWWWWWWWWWW
