WWWWWWWWWWWWWWWWWWW
WGWGWCWCWCWCWCWCWEW
WGWGWCWCWCWCWCWCWCW
WGGGWCWCWCWCWCWCWCW
WWWGWCWCWCWCWCWCWCW
WWWGWCWCWCWCWCWCWCW
WWWWWCWCWCWCWCWCWCW
WGGGWCWCWCWCWCWCWCW
WWWGWCWCWCWCWCWCWCW
WGGGWCCCCCCCCCCCCCW
WGWWWCWWWWWWWWWWWWW
WGGGWCCCCCCCCPGGGGW
WWWWWWWWWWWWWWWWWWW
