WWWWWWWWWWWWWWWWWWW
WGWGWGWGWGWGWGWGWEW
WGWGWCWGWGWGWGWGWGW
WGGGWGWGWGWGWGWGWGW
WWWGWGWGWGWGWGWGWGW
WWWGWGWGWGWGWGWGWGW
WWWWWGWGWGWGWGWGWGW
WGGGWGWGWGWGWGWGWGW
WWWGWGWGWGWGWGWGWGW
WGGGWGGGGGGGGGGGGGW
WGWWWGWWWWWWWWWWWWW
WGGGWGGGGGGGGGGGGPW
WWWWWWWWWWWWWWWWWWW
